+_-_-_-_-_-_-_-   -_-_-_-_-_-_-_-_-_-_-_-+  
|  23 3 ✘ ✘ ✘ ✘---✘ ✘✘ 1 ✘✘ ✘ ✘          |  
|---1+  ✘ |2 | |   --- |3---  ✘✘  -- --+ |  
|   1|  ✘ |--| |--  |  | |    ✘3       | |  
| +     ✘ |  | |    |  | ---✘  3      |  |  
| |  +  ✘     1---      2  2           | |  
| +---+   ✘✘+-1   2-2-3-1-3-2-1-1-2- --+ |  
|                                        |  
|--+✘ +--✘--✘--✘--✘---✘--✘---✘-✘--✘-✘--✘ |  
|1   ✘|                      ✘           |  
|--+  |   +                              |  
|✘2✘  |   |  +-----------✘-------------- |  
|✘ |      |                              |  
|  +------+------✘---------------✘--+    |  
|                                  2|    |  
|    +----+   ----------------------+    |  
|   ✘|                                   |  
| +--|   +-------------------✘-----------|  
|   3|                                  O|  
+_-_-_-_-_-_-_-_-_-_-_-_-_-_-_-_-_-_-_-_-+  